1111111111111111
10000000C0000111
110C1001000P0011
1000000100111011
1000C0000010E011
1111111111111111
