1111111111111111
1100010000000001
110C1001000P0101
1000000100110101
10011C000010E101
1100010000000001
1110010000000001
11000100C0000001
1C011000000C0011
1111111111111111