11111111111111111
10000R00C00000111
110C0001000P00111
10010101001110111
10T1C1000010E0111
10001000001000011
11111111111111111
