1111111111111111
10000R00C0000011
110C0001000P0011
1001010100111011
10T1C1000010E011
1000000000100001
1111111111111111
