11111111111111111
11000100000000001
110C1001000P01001
10000001001101001
10011C000010E1001
11000100000000001
11100100000000001
11000100C00000001
1C011000000C00101
11111111111111111