1111111111111111
10000T00C0000011
110C0001000P0011
1001010100111011
1001C1000010E011
1000100R01000011
1111111111111111
