111111111111111
100000000000011
110C1001000P011
100000010011011
1000C0000010E11
111111111111111