111111111111111111
10T00000C000R01111
110C0001000P001111
100101010011101111
1001C1000010E01111
111111111111111111
