111111111111111
100000000000001
100C100100P0001
111110010000001
100011111111001
100000000000001
100C0001000C001
100000010011101
1000C0000010E01
111111111111111