11111111111111111
10000000C00000111
110C0001000P00111
10010101001110111
1001C1000010E0111
10001000010000111
11111111111111111
