111111111111111
100000000000011
100C100100P0011
100000010011011
1000C0000010E11
111111111111111