1111111111111111
1000000000000111
110C1001000P0011
1000000100111011
1000C0000010E011
1111111111111111
