11111111111111111
110T01000C000C001
110C1001000P110C1
10000001001100001
10011C00R01001001
1100C1000010E1C01
11111111111111111