1111111111111111
10000000C0000011
110C0001000P0011
1001010100111011
1001C1000010E011
1000100001000011
1111111111111111
