11111111111111
10000000000001
100C1001000P01
10000001001101
1000C0000010E1
11111111111111