111111111111111111
1000000000P0011111
110C1001000P011111
100000010011011111
1000C0000010E11111
111111111111111111
