11111111111111111
10000000000001111
110C1001000P01111
10000001001101111
1000C0000010E1111
11111111111111111
